$ANSIBLE_VAULT;1.1;AES256
32343861663136306634616461646132313035386663363333363436643462376362346337363062
3033396565313538323830356639633833613033656536360a363839316464343633396338353366
32363865366133393938313661353563346163323035633566363333373634316633346162356436
6265633834343437660a323462626337663530353866303435303133666539396363396230333065
37313965623361313839666331346430663337343665353834663662353932373366323162623366
3462346663346437663838613432306234323035356132303865
