$ANSIBLE_VAULT;1.1;AES256
62623231306235653061313165656437303332653266353831313538376137313566383230313835
3235353737343865613436616632393266663630346665650a643033303034356633326339343462
63303862623033633938306139616665656461616237613730363662626433323663323938616565
3838386630663835330a383532656162366663316666303634366330633235353437623430393364
39346136316235353566666139396131373963323264376530646636346536643435383730636631
63633465633066616462373030316266333563633238663930313830316634326436313061626461
33373635626264396331396531303931646533393164356430306532373935316230636135343936
32646562633561383035376162613934323031636536326566363863623233343335636639636535
64396333383635393862666436346635303861333830666166636235336433313235
