$ANSIBLE_VAULT;1.1;AES256
33336132393833303936363266373434306263656535656236306131376132623832383363663735
3836363834663836366531393238313638333761656331390a303963376639653039393936396332
33663436646134363766393963626438343332333832393061326361656236383935653534636432
6365656433653236660a306666643534376265363234623235626537653731363535343932373666
33313963306539633536323335633862663330636539663435363437653537393231383735303438
31613538393734336531393761343966666334353363643131643063343832616433363938633163
35643366313966336638636636373764313132353335323861643930633230396639343632336663
64313932633734366434303466373965373137623132653662373864626236366664306439313265
37646366376563303330616333643732333561323561373132303837323032356165
